13 25
#########################
#.$.....$...#..#....$...#
##########..#..#..#######
#..$..$..............#..#
#..#..#..##########..#..#
#..#..#..#..#.....$..#$.#
####..####..####..####..#
#.$...#....$............#
#..#######..#######..####
#..#..$..#$..$.#........#
#..####..####..#..####..#
#...$.......#..#..#..$..#
#########################
aletha 1 1 5
bonny 11 23 1
coleen 7 7 10
donn 11 14 2
elvin 1 23 6
fidel 5 20 3
gerda 3 13 9
